Witnesses -> These dudes I know
Allegedly -> Kinda probably
New Study -> Tumblr post
Rebuild -> Avenge
Space -> Spaaace
Google Glass -> Virtual Boy
Smartphone -> Pokedex
Electric -> Atomic
Senator -> Elf Lord
Car -> Cat
Election -> Eating Contest
Congressional Leaders -> River Spirits
Debate -> Dance-Off
Self Driving -> Uncontrollably Swerving
Poll -> Psychic Reading
Candidate -> Airbender
Drone -> Dog
Vows To -> Probably Won't
At Large -> Very Large
Successfully -> Suddenly
Expands -> Physically Expands
First/Second/Third-Degree -> Friggin' Awful
An Unknown Number -> Like Hundreds
Front Runner -> Blade Runner
Global -> Spherical
Years -> Minutes
No Indication -> Lots Of Signs
Urged Restraint By -> Drunkenly Egged On
Horsepower -> Tons Of Horsemeat
Gaffe -> Magic Spell
Ancient -> Haunted
Star-Studded -> Blood-Soaked
Remains To Be Seen -> Will Never Be Known
Silver Bullet -> Way To Kill Werewolves
Subway System -> Tunnels I Found
Suprising -> Suprising (But Not To Me)
War -> Interplanetary War
Tension -> Sexual Tension
Cautiously Optimistic -> Delusional
Doctor Who -> Big Bang Theory
Win Votes -> Find Pokemon
Behind The Headlines -> Beyond The Grave
Email/Post/Tweet -> Poem
<Name> CEO -> This Guy
Latest -> Final
Disrupt -> Destroy
Scientists -> Andrew Tate And His Friends
You Won't Beleive -> I'm Really Sad About
Corruption -> Shenanigans
Technology/Science -> Wizardry
Finance -> Money Magic
Innovation -> Invention Frenzy
Artificial Intelligence -> Robot Overlords
Immigration -> People Parades
Economy -> Coiniverse
Climate Change -> Weathermorphosis
Company -> Fellowship
Investigation -> Adventure
Judge -> Zooligist
Congressman/Congresswoman -> Clown
Trial -> Church
Experimental -> Randomly Stumbled Upon


